ZZZZZZZZZZZZZZZZZZZZZZZZZZZZZE
ZZZZZZZZZZZZZZZZZZZZZZZZZZZZZE
ZZZZZZZZZZZZZZZZZZZZZZZZZZZZZE
ZZZZZZZZZZZZZZZZZZZZZZZZZZZZZE
ZZZZZZZZZZZZZZZZZZZZZZZZZZZZZE
ZZZZZZZZZZZZZZZZZZZZZZZZZZZZZE
ZZZZZZZZZZZZZZZZZZZZZZZZZZZZZE
ZZZZZZZZZZZZZZZZZZZZZZZZZZZZZE
ZZZZZZZZZZZZZZZZZZZZZZZZZZZZZE
ZZZZZZZZZZZZZZZZZZZZZZZZZZZZZE
ZZZZZZZZZZZZZZZZZZZZZZZZZZZZZE
ZZZZZZZZZZZZZZZZZZZZZZZZZZZZZE
ZZZZZZZZZZZZZZZZZZZZZZZZZZZZZE
ZZZZZZZZZZZZZZZZZZZZZZZZZZZZZE
ZZZZZZZZZZZZZZZZZZZZZZZZZZZZZE
ZZZZZZZZZZZZZZZZZZZZZZZZZZZZZE
ZZZZZZZZZZZZZZZZZZZZZZZZZZZZZE
ZZZZZZZZZZZZZZZZZZZZZZZZZZZZZE
ZZZZZZZZZZZZZZZZZZZZZZZZZZZZZE
ZZZZZZZZZZZZZZZZZZZZZZZZZZZZZE
ENDENDENDENDENDENDENDENDENDEND

|||||||||||||||||||||||||||||E
|||||||||||||||||||||||||||||E
|||||||||||||||||||||||||||||E
|||||||||||||||||||||||||||||E
|||||||||||||||||||||||||||||E
|||||||||||||||||||||||||||||E
|||||||||||||||||||||||||||||E
|||||||||||||||||||||||||||||E
|||||||||||||||||||||||||||||E
|||||||||||||||||||||||||||||E
|||||||||||||||||||||||||||||E
|||||||||||||||||||||||||||||E
|||||||||||||||||||||||||||||E
|||||||||||||||||||||||||||||E
|||||||||||||||||||||||||||||E
|||||||||||||||||||||||||||||E
|||||||||||||||||||||||||||||E
|||||||||||||||||||||||||||||E
|||||||||||||||||||||||||||||E
|||||||||||||||||||||||||||||E
ENDENDENDENDENDENDENDENDENDEND
