ZZZZZZZZZZZZZZZZZZZZZZZZZZZZZZZZZZZE
ZZZZZZZZZZZZZZZZZZZZZZZZZZZZZZZZZZZE
ZZZZZZZZZZZZZZZZZZZZZZZZZZZZZZZZZZZE
ZZZZZZZZZZZZZZZZZZZZZZZZZZZZZZZZZZZE
ZZZZZZZZZZZZZZZZZZZZZZZZZZZZZZZZZZZE
ZZZZZZZZZZZZZZZZZZZZZZZZZZZZZZZZZZZE
ZZZZZZZZZZZZZZZZZZZZZZZZZZZZZZZZZZZE
ZZZZZZZZZZZZZZZZZZZZZZZZZZZZZZZZZZZE
ZZZZZZZZZZZZZZZZZZZZZZZZZZZZZZZZZZZE
ZZZZZZZZZZZZZZZZZZZZZZZZZZZZZZZZZZZE
ZZZZZZZZZZZZZZZZZZZZZZZZZZZZZZZZZZZE
ZZZZZZZZZZZZZZZZZZZZZZZZZZZZZZZZZZZE
ZZZZZZZZZZZZZZZZZZZZZZZZZZZZZZZZZZZE
ZZZZZZZZZZZZZZZZZZZZZZZZZZZZZZZZZZZE
ZZZZZZZZZZZZZZZZZZZZZZZZZZZZZZZZZZZE
ZZZZZZZZZZZZZZZZZZZZZZZZZZZZZZZZZZZE
ZZZZZZZZZZZZZZZZZZZZZZZZZZZZZZZZZZZE
ZZZZZZZZZZZZZZZZZZZZZZZZZZZZZZZZZZZE
ZZZZZZZZZZZZZZZZZZZZZZZZZZZZZZZZZZZE
ZZZZZZZZZZZZZZZZZZZZZZZZZZZZZZZZZZZE
ZZZZZZZZZZZZZZZZZZZZZZZZZZZZZZZZZZZE
ZZZZZZZZZZZZZZZZZZZZZZZZZZZZZZZZZZZE
EZZZZZZNDENDENDENDENDENDENDENDENDEND

______|||||||||||||||||||||||||||||E
|______||||||||||||||||||||||||||||E
||||||______|||||||||||||||||||||||E
|||||||||||______||||||||||||||||||E
||||||||||||||||______|||||||||||||E
|||||||||||||||||||||______||||||||E
||||||||||||||||||||||||||______|||E
|||||||||||||||||||||||||||||______E
|||||||||||||||||||||||||||||______E
|||||||||||||||||||||||||||||______E
|||||||||||||||||||||||||||||______E
|||||||||||||||||||||||||||||______E
|||||||||||||||||||||||||||||______E
|||||||||||||||||||||||||||||______E
|||||||||||||||||||||||||||||______E
|||||||||||||||||||||||||||||______E
|||||||||||||||||||||||||||||______E
|||||||||||||||||||||||||||||______E
|||||||||||||||||||||||||||||______E
|||||||||||||||||||||||||||||______E
|||||||||||||||||||||||||||||______E
|||||||||||||||||||||||||||||______E
E______NDENDENDENDENDENDENDENDENDEND

E
