----------
--w1sbpkez
----------
----------
-PRINTED--
--TEXT----
----------
-w-1-s-b-p
k-e-z-----
----------

----------
--w1sbpkez
----------
----------
-PRINTED--
--TEXT----
----------
-w-1-s-b-p
k-e-z-----
----------

T
