----------
--w1sbpk-z
-----e0e--
----------
-PRINTED--
--TEXT----
----------
-w-1-s-b-p
keqez-----
----------

E
