----------
--w1sbpk-z
-----e0e--
----------
-PRINTED--
--TEXT-e5e
----------
-w-1-s-b-p
ke100ez---
----------

E
